R 10000 8000
NO ./textures/wall1.xpm
SO ./textures/wall2.xpm
WE ./textures/wall3.xpm
EA ./textures/wall4.xpm
S ./textures/sprite1.xpm
F 220,100,0
C 225,30,0
11111111111111111111111111111
10000000200000100020000000001
10000000000020100000000200001
10002000000000100002000000001
10000000000000120000020000001
10002000020000100002000020001
10000000000000000000000000001
11111111111110001111111111111
10000010000000000000000200001
10000010000200000020000000201
10000000000000020000000000001
10002010000020000002000200W01
10000010002000000200002000001
11111111111111111111111111111
